11 11 4
9 8
1 4
8 8
9 1
wwwwwwwwwww
wS KDC    w
w  wwCww  w
wC    TCwKw
w  wwDw w w
wC Cw   wKw
wwwTDCwwwww
w   DTTC  w
wTwwwww   w
wCC    K Ew
wwwwwwwwwww
