11 11 4
1 3
9 5
3 7
9 7
wwwwwwwwwww
wSCK Cw  Kw
ww Dw DCwww
w C T w  Cw
w  wwwww  w
wKwC TT   w
w  C  DC  w
wK   Cw   w
w    Tww  w
w  T Kw CEw
wwwwwwwwwww
